ad.hma.rocks |	Andorra, Andorra la Vella | ad | tcp | udp
ae.hma.rocks |	United Arab Emirates, Dubai | ae | tcp | udp
af.hma.rocks |	Afghanistan, Kabul | af | tcp | udp
ag.hma.rocks |	Antigua and Barbuda, Saint John's | ag | tcp | udp
ai.hma.rocks |	Anguilla, The Valley | ai | tcp | udp
al.hma.rocks |	Albania, Tirana | al | tcp | udp
am.hma.rocks |	Armenia, Tsaghkadzor | am | tcp | udp
ao.hma.rocks |	Angola, Luanda | ao | tcp | udp
ar.hma.rocks |	Argentina, Buenos Aires | ar | tcp | udp
as.hma.rocks |	American Samoa, Pago Pago | as | tcp | udp
at.hma.rocks |	Austria, Carinthia, Klagenfurt | at | tcp | udp
au.hma.rocks |	Australia, New South Wales, Sydney | au | tcp | udp
aw.hma.rocks |	Aruba, Palm Beach | aw | tcp | udp
ax.hma.rocks |	Aland Islands, Mariehamn | ax | tcp | udp
az.hma.rocks |	Azerbaijan, Qusar | az | tcp | udp
ba.hma.rocks |	Bosnia, Sarajevo | ba | tcp | udp
bb.hma.rocks |	Barbados, Worthing | bb | tcp | udp
bd.hma.rocks |	Bangladesh, Dhaka | bd | tcp | udp
be.hma.rocks |	Belgium, Brussels | be | tcp | udp
bf.hma.rocks |	Burkina Faso, Ouagadougou | bf | tcp | udp
bg.hma.rocks |	Bulgaria, Sofia | bg | tcp | udp
bh.hma.rocks |	Bahrain, Manama | bh | tcp | udp
bi.hma.rocks |	Burundi, Bujumbura | bi | tcp | udp
bj.hma.rocks |	Benin, Cotonou | bj | tcp | udp
bm.hma.rocks |	Bermuda, Hamilton | bm | tcp | udp
bn.hma.rocks |	Brunei, Jerudong | bn | tcp | udp
bo.hma.rocks |	Bolivia, Santa Cruz | bo | tcp | udp
br.hma.rocks |	Brazil, Joao Pessoa | br | tcp | udp
bs.hma.rocks |	Bahamas, Freeport | bs | tcp | udp
bt.hma.rocks |	Bhutan, Thimphu | bt | tcp | udp
bw.hma.rocks |	Botswana, Gaborone | bw | tcp | udp
by.hma.rocks |	Belarus, Minsk | by | tcp | udp
bz.hma.rocks |	Belize, Belize City | bz | tcp | udp
ca.hma.rocks |	Canada, British Columbia, Vancouver | ca | tcp | udp
cc.hma.rocks |	Cocos Islands, West Island | cc | tcp | udp
cd.hma.rocks |	Congo, Kinshasa | cd | tcp | udp
cf.hma.rocks |	Central African Republic, Bangassou | cf | tcp | udp
cg.hma.rocks |	Republic of the Congo, Brazzaville | cg | tcp | udp
ch.hma.rocks |	Switzerland, Zurich | ch | tcp | udp
ci.hma.rocks |	Cote d`Ivoire, Yamoussoukro | ci | tcp | udp
ck.hma.rocks |	Cook Islands, Avarua | ck | tcp | udp
cl.hma.rocks |	Chile, Santiago | cl | tcp | udp
cm.hma.rocks |	Cameroon, Yaounde | cm | tcp | udp
cn.hma.rocks |	China, Sichuan Sheng, Chengdu | cn | tcp | udp
co.hma.rocks |	Colombia, San Andres | co | tcp | udp
cr.hma.rocks |	Costa Rica, San Jose | cr | tcp | udp
cu.hma.rocks |	Cuba, Havana | cu | tcp | udp
cv.hma.rocks |	Cape Verde, Cidade Velha | cv | tcp | udp
cx.hma.rocks |	Christmas Island, Flying Fish Cove | cx | tcp | udp
cy.hma.rocks |	Cyprus, Limassol | cy | tcp | udp
cz.hma.rocks |	Czech Republic, Prague | cz | tcp | udp
de.hma.rocks |	Germany, Hesse, Frankfurt | de | tcp | udp
dj.hma.rocks |	Republic of Djibouti, Djibouti | dj | tcp | udp
dk.hma.rocks |	Denmark, Copenhagen | dk | tcp | udp
dm.hma.rocks |	Dominica, Marigot | dm | tcp | udp
do.hma.rocks |	Dominican Republic, Punta Cana | do | tcp | udp
dz.hma.rocks |	Algeria, Annaba | dz | tcp | udp
ec.hma.rocks |	Ecuador, Quito | ec | tcp | udp
ee.hma.rocks |	Estonia, Tallinn | ee | tcp | udp
eg.hma.rocks |	Egypt, Cairo | eg | tcp | udp
er.hma.rocks |	Eritrea, Asmara | er | tcp | udp
es.hma.rocks |	Spain, Alicante | es | tcp | udp
et.hma.rocks |	Ethiopia, Gondar | et | tcp | udp
fi.hma.rocks |	Finland, Helsinki | fi | tcp | udp
fj.hma.rocks |	Fiji, Nadi | fj | tcp | udp
fk.hma.rocks |	Falkland Islands, Stanley | fk | tcp | udp
fo.hma.rocks |	Faroe Islands, Torshavn | fo | tcp | udp
fr.hma.rocks |	France, Paris | fr | tcp | udp
ga.hma.rocks |	Gabon, Libreville | ga | tcp | udp
gb.hma.rocks |	UK | gb | tcp | udp
london.gb.hma.rocks |	UK, London | gb | tcp | udp
scotland.gb.hma.rocks |	UK, Scotland, Glasgow | gb | tcp | udp
gd.hma.rocks |	Grenada, Saint George | gd | tcp | udp
ge.hma.rocks |	Georgia, Tbilisi | ge | tcp | udp
gh.hma.rocks |	Ghana, Accra | gh | tcp | udp
gi.hma.rocks |	Gibraltar, Catalan | gi | tcp | udp
gl.hma.rocks |	Greenland, Ilulissat | gl | tcp | udp
gm.hma.rocks |	Gambia, Serekunda | gm | tcp | udp
gn.hma.rocks |	Guinea, Conakry | gn | tcp | udp
gp.hma.rocks |	Guadeloupe, Le Gosier | gp | tcp | udp
gq.hma.rocks |	Equatorial Guinea, Malabo | gq | tcp | udp
gr.hma.rocks |	Greece, Patras | gr | tcp | udp
gt.hma.rocks |	Guatemala, Guatemala City | gt | tcp | udp
gu.hma.rocks |	Guam, Tamuning | gu | tcp | udp
gw.hma.rocks |	Guinea-Bissau, Bissau | gw | tcp | udp
gy.hma.rocks |	Guyana, Barima-Waini | gy | tcp | udp
hk.hma.rocks |	Hong Kong, Shatin | hk | tcp | udp
hn.hma.rocks |	Honduras, Tegucigalpa | hn | tcp | udp
hr.hma.rocks |	Croatia, Zagreb | hr | tcp | udp
ht.hma.rocks |	Haiti, Cap-Haitien | ht | tcp | udp
hu.hma.rocks |	Hungary, Budapest | hu | tcp | udp
id.hma.rocks |	Indonesia, Jakarta | id | tcp | udp
ie.hma.rocks |	Ireland, Dublin | ie | tcp | udp
il.hma.rocks |	Israel, Petah Tikva | il | tcp | udp
in.hma.rocks |	India, Maharashtra, Mumbai | in | tcp | udp
iq.hma.rocks |	Iraq, Baghdad | iq | tcp | udp
ir.hma.rocks |	Iran, Isfahan | ir | tcp | udp
is.hma.rocks |	Iceland, Reykjavik | is | tcp | udp
it.hma.rocks |	Italy, Pordenone, Porcia | it | tcp | udp
jm.hma.rocks |	Jamaica, Montego Bay | jm | tcp | udp
jo.hma.rocks |	Jordan, Amman | jo | tcp | udp
jp.hma.rocks |	Japan, Okinawa, Onna | jp | tcp | udp
ke.hma.rocks |	Kenya, Nairobi | ke | tcp | udp
kg.hma.rocks |	Kyrgyzstan, Bishkek | kg | tcp | udp
kh.hma.rocks |	Cambodia, Phnom Penh | kh | tcp | udp
ki.hma.rocks |	Kiribati, Umwa Village | ki | tcp | udp
km.hma.rocks |	Comoros, Ouani | km | tcp | udp
kn.hma.rocks |	Saint Kitts and Nevis, Basseterre | kn | tcp | udp
kp.hma.rocks |	North Korea, Manpo | kp | tcp | udp
kr.hma.rocks |	South Korea, Seoul | kr | tcp | udp
kw.hma.rocks |	Kuwait, Kuwait City | kw | tcp | udp
ky.hma.rocks |	Cayman Islands, Spot Bay | ky | tcp | udp
kz.hma.rocks |	Kazakhstan, Shymkent | kz | tcp | udp
la.hma.rocks |	Laos, Thakhek | la | tcp | udp
lb.hma.rocks |	Lebanon, Beirut | lb | tcp | udp
lc.hma.rocks |	Saint Lucia, Gros Islet | lc | tcp | udp
li.hma.rocks |	Liechtenstein, Vaduz | li | tcp | udp
lk.hma.rocks |	Sri Lanka, Moratuwa | lk | tcp | udp
lr.hma.rocks |	Liberia, Monrovia | lr | tcp | udp
ls.hma.rocks |	Lesotho, Peka | ls | tcp | udp
lt.hma.rocks |	Lithuania, Siauliai | lt | tcp | udp
lu.hma.rocks |	Luxembourg | lu | tcp | udp
lv.hma.rocks |	Latvia, Riga | lv | tcp | udp
ly.hma.rocks |	Libya, Ghadames | ly | tcp | udp
ma.hma.rocks |	Morocco, Fes | ma | tcp | udp
mc.hma.rocks |	Monaco, Monaco | mc | tcp | udp
md.hma.rocks |	Moldova, Chisinau | md | tcp | udp
me.hma.rocks |	Montenegro, Becici | me | tcp | udp
mg.hma.rocks |	Madagascar, Antsiranana | mg | tcp | udp
mk.hma.rocks |	Macedonia, Skopje | mk | tcp | udp
ml.hma.rocks |	Mali, Bamako | ml | tcp | udp
mm.hma.rocks |	Myanmar, Yangon | mm | tcp | udp
mn.hma.rocks |	Mongolia, Suhbaatar | mn | tcp | udp
mo.hma.rocks |	Macau, Macau | mo | tcp | udp
ms.hma.rocks |	Montserrat, Plymouth | ms | tcp | udp
mt.hma.rocks |	Malta, Cospicua | mt | tcp | udp
mu.hma.rocks |	Mauritius, Port Louis | mu | tcp | udp
mv.hma.rocks |	Maldives, Male | mv | tcp | udp
mw.hma.rocks |	Malawi, Lilongwe | mw | tcp | udp
mx.hma.rocks |	Mexico, Sinaloa, Mazatlan | mx | tcp | udp
my.hma.rocks |	Malaysia, Kuala Lumpur | my | tcp | udp
mz.hma.rocks |	Mozambique, Pemba | mz | tcp | udp
na.hma.rocks |	Namibia, Windhoek | na | tcp | udp
nc.hma.rocks |	New Caledonia, Noumea | nc | tcp | udp
ne.hma.rocks |	Niger, Niamey | ne | tcp | udp
nf.hma.rocks |	Norfolk Island, Kingston | nf | tcp | udp
ng.hma.rocks |	Nigeria, Lagos | ng | tcp | udp
ni.hma.rocks |	Nicaragua, Managua | ni | tcp | udp
nl.hma.rocks |	Netherlands, Amsterdam | nl | tcp | udp
no.hma.rocks |	Norway, Oslo | no | tcp | udp
np.hma.rocks |	Nepal, Janakpur | np | tcp | udp
nr.hma.rocks |	Nauru, Anabar | nr | tcp | udp
nu.hma.rocks |	Niue, Alofi | nu | tcp | udp
nz.hma.rocks |	New Zealand, Auckland | nz | tcp | udp
om.hma.rocks |	Oman, Salalah | om | tcp | udp
pa.hma.rocks |	Panama, Panama City | pa | tcp | udp
pe.hma.rocks |	Peru, Cusco | pe | tcp | udp
pg.hma.rocks |	Papua New Guinea, Alotau | pg | tcp | udp
ph.hma.rocks |	Philippines, Baguio | ph | tcp | udp
pk.hma.rocks |	Pakistan, Karachi | pk | tcp | udp
pl.hma.rocks |	Poland, Warsaw | pl | tcp | udp
pm.hma.rocks |	Saint Pierre and Miquelon, Saint-Pierre | pm | tcp | udp
pn.hma.rocks |	Pitcairn Islands, Adamstown | pn | tcp | udp
pr.hma.rocks |	Puerto Rico, San Juan | pr | tcp | udp
ps.hma.rocks |	Palestine, Bethlehem | ps | tcp | udp
pt.hma.rocks |	Portugal, Leiria | pt | tcp | udp
pw.hma.rocks |	Palau, Melekeok | pw | tcp | udp
py.hma.rocks |	Paraguay, Boqueron | py | tcp | udp
qa.hma.rocks |	Qatar, Doha | qa | tcp | udp
ro.hma.rocks |	Romania, Bucharest | ro | tcp | udp
rs.hma.rocks |	Serbia, Belgrade | rs | tcp | udp
ru.hma.rocks |	Russia, Moscow | ru | tcp | udp
rw.hma.rocks |	Rwanda, Kigali | rw | tcp | udp
sa.hma.rocks |	Saudi Arabia, Riyadh | sa | tcp | udp
sb.hma.rocks |	Solomon Islands, Honiara | sb | tcp | udp
sd.hma.rocks |	Sudan, Khartoum | sd | tcp | udp
se.hma.rocks |	Sweden, Stockholm, Nacka | se | tcp | udp
sg.hma.rocks |	Republic of Singapore, Singapore | sg | tcp | udp
sh.hma.rocks |	Saint Helena, Tristan Da Cunha | sh | tcp | udp
si.hma.rocks |	Slovenia, Vrhnika | si | tcp | udp
sj.hma.rocks |	Svalbard and Jan Mayen, Longyearbyen | sj | tcp | udp
sk.hma.rocks |	Slovakia, Bratislava | sk | tcp | udp
sm.hma.rocks |	San Marino, San Marino | sm | tcp | udp
sn.hma.rocks |	Senegal, Dakar | sn | tcp | udp
so.hma.rocks |	Somalia, Afgooye | so | tcp | udp
sr.hma.rocks |	Suriname, Paramaribo | sr | tcp | udp
st.hma.rocks |	Sao Tome and Principe, Sao Tome | st | tcp | udp
sv.hma.rocks |	El Salvador, San Miguel | sv | tcp | udp
sy.hma.rocks |	Syria, Ad Darah | sy | tcp | udp
sz.hma.rocks |	Swaziland, Manzini | sz | tcp | udp
tc.hma.rocks |	Turks and Caicos Islands, Balfour Town | tc | tcp | udp
td.hma.rocks |	Chad, N'Djamena | td | tcp | udp
tg.hma.rocks |	Togo, Lome | tg | tcp | udp
th.hma.rocks |	Thailand, Bangkok | th | tcp | udp
tj.hma.rocks |	Tajikistan, Dushanbe | tj | tcp | udp
tk.hma.rocks |	Tokelau, Atafu | tk | tcp | udp
tm.hma.rocks |	Turkmenistan, Ashgabat | tm | tcp | udp
tn.hma.rocks |	Tunisia, Mahdia | tn | tcp | udp
to.hma.rocks |	Tonga, Nukualofa | to | tcp | udp
tr.hma.rocks |	Turkey, Istanbul | tr | tcp | udp
tt.hma.rocks |	Trinidad and Tobago, San Fernando | tt | tcp | udp
tv.hma.rocks |	Tuvalu, Vaitupu | tv | tcp | udp
tw.hma.rocks |	Taiwan, Taipei | tw | tcp | udp
tz.hma.rocks |	Tanzania, Arusha | tz | tcp | udp
ua.hma.rocks |	Ukraine, Odessa | ua | tcp | udp
ug.hma.rocks |	Uganda, Kampala | ug | tcp | udp
us.hma.rocks |	USA | us | tcp | udp
liberty.hma.rocks | USA, Liberty Island | us | tcp | udp
ak.us.hma.rocks |	USA, Alaska, Anchorage | us | tcp | udp
al.us.hma.rocks |	USA, Alabama, Montgomery | us | tcp | udp
ar.us.hma.rocks |	USA, Arkansas, Magnolia | us | tcp | udp
az.us.hma.rocks |	USA, Arizona, Phoenix | us | tcp | udp
ca.us.hma.rocks |	USA, California, Los Angeles | us | tcp | udp
ct.us.hma.rocks |	USA, Connecticut, Trumbull | us | tcp | udp
de.us.hma.rocks |	USA, Delaware, Wilmington | us | tcp | udp
fl.us.hma.rocks |	USA, Florida, Miami | us | tcp | udp
ga.us.hma.rocks |	USA, Georgia, Atlanta | us | tcp | udp
hi.us.hma.rocks |	USA, Hawaii, Honolulu | us | tcp | udp
ia.us.hma.rocks |	USA, Iowa, Des Moines | us | tcp | udp
id.us.hma.rocks |	USA, Idaho, Idaho Falls | us | tcp | udp
il.us.hma.rocks |	USA, Illinois, Chicago | us | tcp | udp
in.us.hma.rocks |	USA, Indiana, South Bend | us | tcp | udp
ks.us.hma.rocks |	USA, Kansas, Wichita | us | tcp | udp
ky.us.hma.rocks |	USA, Kentucky, Louisville | us | tcp | udp
la.us.hma.rocks |	USA, Louisiana, New Orleans | us | tcp | udp
ma.us.hma.rocks |	USA, Massachusetts, Boston | us | tcp | udp
md.us.hma.rocks |	USA, Maryland, Baltimore | us | tcp | udp
me.us.hma.rocks |	USA, Maine, Bath | us | tcp | udp
mi.us.hma.rocks |	USA, Michigan, Lansing | us | tcp | udp
mn.us.hma.rocks |	USA, Minnesota, Saint Paul | us | tcp | udp
mo.us.hma.rocks |	USA, Missouri, Kansas City | us | tcp | udp
ms.us.hma.rocks |	USA, Mississippi, Louisville | us | tcp | udp
mt.us.hma.rocks |	USA, Montana, Billings | us | tcp | udp
nc.us.hma.rocks |	USA, North Carolina, Asheville | us | tcp | udp
nd.us.hma.rocks |	USA, North Dakota, Grand Forks | us | tcp | udp
ne.us.hma.rocks |	USA, Nebraska, Omaha | us | tcp | udp
nh.us.hma.rocks |	USA, New Hampshire, Bedford | us | tcp | udp
nm.us.hma.rocks |	USA, New Mexico, Albuquerque | us | tcp | udp
nv.us.hma.rocks |	USA, Nevada, Las Vegas | us | tcp | udp
ny.us.hma.rocks |	USA, New York, Manhattan | us | tcp | udp
oh.us.hma.rocks |	USA, Ohio, Columbus | us | tcp | udp
ok.us.hma.rocks |	USA, Oklahoma, Oklahoma City | us | tcp | udp
pa.us.hma.rocks |	USA, Pennsylvania, Wilkes-Barre | us | tcp | udp
ri.us.hma.rocks |	USA, Rhode Island, Providence | us | tcp | udp
sc.us.hma.rocks |	USA, South Carolina, Columbia | us | tcp | udp
sd.us.hma.rocks |	USA, South Dakota, Sioux Falls | us | tcp | udp
tn.us.hma.rocks |	USA, Tennessee, Nashville | us | tcp | udp
tx.us.hma.rocks |	USA, Texas, Dallas | us | tcp | udp
ut.us.hma.rocks |	USA, Utah, Salt Lake City | us | tcp | udp
va.us.hma.rocks |	USA, Virginia, Ashburn | us | tcp | udp
vt.us.hma.rocks |	USA, Vermont, Rutland | us | tcp | udp
wa.us.hma.rocks |	USA, Washington, Seattle | us | tcp | udp
wi.us.hma.rocks |	USA, Wisconsin, Madison | us | tcp | udp
wv.us.hma.rocks |	USA, West Virginia, Philippi | us | tcp | udp
wy.us.hma.rocks |	USA, Wyoming, Cheyenne | us | tcp | udp
uy.hma.rocks |	Uruguay, Montevideo | uy | tcp | udp
uz.hma.rocks |	Uzbekistan, Samarkand | uz | tcp | udp
va.hma.rocks |	Vatican, Vatican City | va | tcp | udp
vc.hma.rocks |	Saint Vincent and the Grenadines, Kingstown | vc | tcp | udp
ve.hma.rocks |	Venezuela, Caracas | ve | tcp | udp
vg.hma.rocks |	British Virgin Islands, Tortola | vg | tcp | udp
vn.hma.rocks |	Vietnam, Ho Chi Minh City | vn | tcp | udp
vu.hma.rocks |	Vanuatu, Loltong | vu | tcp | udp
ws.hma.rocks |	Samoa, Matatufu | ws | tcp | udp
ye.hma.rocks |	Yemen, Sanaa | ye | tcp | udp
za.hma.rocks |	South Africa, Johannesburg | za | tcp | udp
zm.hma.rocks |	Zambia, Lusaka | zm | tcp | udp
zw.hma.rocks |	Zimbabwe, Harare | zw | tcp | udp